SSSSSSSSSSS
S2S2S2S2S2S
S222222222S
S2XBBBBX2S2
S222P22222S
S333333333S
S3X3X3X3X3S
