SSSSSSSSSSS
S  S  S  S 
S2S2S2S2S2S
S222222222S
SBSXSXSXSBP
S222222222S
