SSS2X2X2XSSS
SS33333333SS
S2X2X2X2X2XS
S33P33P33P33
S2XBBBBXBBBB
S33333333333
S3X3X3X3X3X3
S33333333333
